* * * * # # # % # # # * * * * 
* * * * # # # ~ # # # * * * * 
* * * * # # # # # # # * * * * 
* * * # # # # # # # # # * * * 
# # # # # # * * * # # # # # # 
# # # # # # # # # # # # # # # 
# # # # * # ^ ^ ^ # * # # # # 
% ~ # # * # ^ @ ^ # * # # ~ % 
# # # # * # ^ ^ ^ # * # # # # 
# # # # # # # # # # # # # # # 
# # # # # # * * * # # # # # # 
* * * # # # # # # # # # * * * 
* * * * # # # # # # # * * * * 
* * * * # # # ~ # # # * * * * 
* * * * # # # % # # # * * * * 
